99,99,99,99,99,99,00,01,01,01,01,01,01,01,01,01,03,99,99,99,99,99,99,99,99,99,99,99,99,99,99,99,99,99,99,99,99,99
99,99,99,99,99,00,71,56,56,56,56,56,56,56,56,56,70,03,99,99,99,99,99,99,99,99,99,99,99,99,99,99,99,99,99,99,99,99
99,99,99,99,00,71,58,99,99,99,99,99,99,99,99,99,55,70,02,02,02,02,02,02,03,99,99,99,99,99,99,99,99,99,99,99,99,99
99,99,99,99,10,58,99,99,99,99,99,99,99,99,99,99,99,55,57,57,57,57,57,57,70,03,99,99,99,99,99,99,99,99,99,99,99,99
99,99,99,99,29,99,99,99,99,99,99,99,99,99,99,99,99,99,99,99,99,99,99,99,55,70,03,99,99,99,99,99,99,99,99,99,99,99
99,99,99,99,29,99,59,54,07,08,99,99,99,99,99,99,99,99,99,99,99,99,99,99,99,55,70,03,99,99,99,99,99,99,99,99,99,99
99,99,99,99,29,99,24,99,99,18,19,99,99,99,99,99,99,99,99,99,99,99,99,99,99,99,55,70,03,99,99,99,99,99,99,99,99,99
99,99,99,99,29,99,34,03,99,99,29,99,99,99,99,99,99,99,99,99,99,99,99,99,99,99,99,55,70,03,99,99,99,99,99,99,99,99
99,99,99,99,29,99,55,13,99,99,22,54,54,54,54,54,54,07,08,99,99,99,99,99,99,99,99,99,55,13,99,99,99,99,99,99,99,99
99,99,99,99,29,99,99,24,99,99,99,99,99,99,99,99,99,99,18,08,99,99,99,99,99,99,99,99,99,24,99,99,99,99,99,99,99,99
99,99,99,99,29,99,99,24,02,02,02,02,02,02,02,02,40,99,99,18,19,99,99,99,99,99,99,99,99,24,99,99,99,99,99,99,99,99
99,99,99,99,29,99,99,24,57,57,57,57,57,57,57,57,50,02,99,02,29,99,99,99,99,99,99,99,99,24,05,06,07,08,99,99,99,99
99,99,99,99,29,99,99,24,99,99,99,99,99,99,99,99,42,57,99,57,29,99,99,99,99,99,99,99,99,24,15,99,99,18,19,99,99,99
99,99,99,99,29,99,99,24,99,99,99,99,99,99,99,99,30,99,99,99,29,99,99,99,99,99,99,99,99,26,99,99,99,99,29,99,99,99
99,99,99,99,29,99,99,24,99,99,99,99,99,99,99,99,99,99,99,99,29,99,99,99,99,99,99,99,99,43,99,99,99,99,29,99,99,99
99,99,99,99,29,99,99,24,99,99,99,99,99,99,99,99,40,99,99,99,29,99,99,99,99,99,99,99,99,34,35,99,99,38,39,99,99,99
99,99,99,99,29,99,99,24,99,99,99,99,99,99,99,99,29,99,99,99,29,99,99,99,99,99,99,99,99,55,45,46,77,48,58,99,99,99
99,99,05,06,29,99,99,24,99,99,99,99,99,99,99,99,29,99,99,99,30,99,99,99,99,99,99,99,99,99,55,57,62,58,99,99,99,99
99,74,15,99,30,99,99,24,54,54,99,54,54,54,54,54,29,99,99,99,99,99,99,99,99,99,99,99,99,99,99,99,99,99,99,99,99,99
99,75,35,99,40,99,99,24,99,99,99,99,99,99,99,99,29,99,99,99,40,99,99,99,99,99,99,99,99,99,99,99,40,99,99,99,99,99
99,99,45,46,29,99,99,24,99,99,99,99,99,99,99,99,29,99,99,99,29,99,99,99,99,99,99,99,99,99,05,06,78,08,99,99,99,99
99,99,55,57,29,99,99,33,99,99,99,99,99,99,99,99,29,99,99,99,29,99,99,99,99,99,99,99,99,14,15,99,99,18,19,99,99,99
99,99,99,99,29,99,99,43,99,99,99,99,99,99,99,99,29,99,99,99,29,99,99,99,99,99,99,99,99,33,99,99,99,99,29,99,99,99
99,99,99,99,29,99,99,24,99,99,99,99,99,99,99,99,29,99,99,99,29,99,99,99,99,99,99,99,99,99,99,99,99,99,29,99,99,99
99,99,99,99,29,99,99,24,54,54,99,54,54,54,54,54,22,54,99,54,29,99,99,99,99,99,99,99,99,24,35,99,99,38,39,99,99,99
99,99,99,99,29,99,99,24,99,99,99,99,99,99,99,99,99,99,99,38,39,99,99,99,99,99,99,99,99,24,45,46,47,48,58,99,99,99
99,99,99,99,29,99,99,64,99,99,99,99,99,99,99,99,99,99,38,48,58,99,99,99,99,99,99,99,99,24,55,56,56,58,99,99,99,99
99,99,99,99,29,99,14,15,99,99,52,02,02,02,02,02,02,47,48,58,99,99,99,99,99,99,99,99,99,24,99,99,99,99,99,99,99,99
99,99,99,99,29,99,24,99,99,38,82,57,57,57,57,57,57,57,58,99,99,99,99,99,99,99,99,99,99,31,99,99,99,99,99,99,99,99
99,99,99,99,29,99,26,02,47,48,58,99,99,99,99,99,99,99,99,99,99,99,99,99,99,99,99,99,32,69,99,99,99,99,99,99,99,99
99,99,99,99,29,99,04,57,57,58,99,99,99,99,99,99,99,99,99,99,99,99,99,99,99,99,99,32,69,99,99,99,99,99,99,99,99,99
99,99,99,99,29,99,99,99,99,99,99,99,99,99,99,99,99,99,99,99,99,99,99,99,99,99,32,69,99,99,99,99,99,99,99,99,99,99
99,99,99,99,29,99,99,99,99,99,99,99,99,99,99,99,99,99,99,99,99,99,99,99,99,32,69,99,99,99,99,99,99,99,99,99,99,99
99,99,99,99,80,99,99,99,99,99,99,99,99,99,99,99,99,99,99,99,99,99,99,99,32,69,99,99,99,99,99,99,99,99,99,99,99,99
99,99,99,99,66,81,99,99,99,99,99,99,99,99,99,99,99,79,54,54,54,54,54,68,69,99,99,99,99,99,99,99,99,99,99,99,99,99
99,99,99,99,99,66,81,99,99,99,99,99,99,99,99,99,32,69,99,99,99,99,99,99,99,99,99,99,99,99,99,99,99,99,99,99,99,99
99,99,99,99,99,99,66,67,54,54,54,54,54,54,54,68,69,99,99,99,99,99,99,99,99,99,99,99,99,99,99,99,99,99,99,99,99,99
99,99,99,99,99,99,99,99,99,99,99,99,99,99,99,99,99,99,99,99,99,99,99,99,99,99,99,99,99,99,99,99,99,99,99,99,99,99

0,0,0,0,0,0,1,1,1,1,1,1,1,1,1,1,1,0,0,0,0,0,0,0,0,0,0,0,0,0,0,0,0,0,0,0,0,0
0,0,0,0,0,1,1,0,0,0,0,0,0,0,0,0,1,1,0,0,0,0,0,0,0,0,0,0,0,0,0,0,0,0,0,0,0,0
0,0,0,0,1,1,0,0,0,0,0,0,0,0,0,0,0,1,1,1,1,1,1,1,1,0,0,0,0,0,0,0,0,0,0,0,0,0
0,0,0,0,1,0,0,0,0,0,0,0,0,0,0,0,0,0,0,0,0,0,0,0,1,1,0,0,0,0,0,0,0,0,0,0,0,0
0,0,0,0,1,0,0,0,0,0,0,0,0,0,0,0,0,0,0,0,0,0,0,0,0,1,1,0,0,0,0,0,0,0,0,0,0,0
0,0,0,0,1,0,1,1,1,1,0,0,0,0,0,0,0,0,0,0,0,0,0,0,0,0,1,1,0,0,0,0,0,0,0,0,0,0
0,0,0,0,1,0,1,0,0,1,1,0,0,0,0,0,0,0,0,0,0,0,0,0,0,0,0,1,1,0,0,0,0,0,0,0,0,0
0,0,0,0,1,0,1,0,0,0,1,0,0,0,0,0,0,0,0,0,0,0,0,0,0,0,0,0,1,1,0,0,0,0,0,0,0,0
0,0,0,0,1,0,1,1,0,0,1,1,1,1,1,1,1,1,1,0,0,0,0,0,0,0,0,0,0,1,0,0,0,0,0,0,0,0
0,0,0,0,1,0,0,1,0,0,0,0,0,0,0,0,0,0,1,1,0,0,0,0,0,0,0,0,0,1,0,0,0,0,0,0,0,0
0,0,0,0,1,0,0,1,1,1,1,1,1,1,1,1,0,0,0,1,1,0,0,0,0,0,0,0,0,1,0,0,0,0,0,0,0,0
0,0,0,0,1,0,0,1,0,0,0,0,0,0,0,0,1,1,0,1,1,0,0,0,0,0,0,0,0,1,1,1,1,1,0,0,0,0
0,0,0,0,1,0,0,1,0,0,0,0,0,0,0,0,1,0,0,0,1,0,0,0,0,0,0,0,0,1,1,0,0,1,1,0,0,0
0,0,0,0,1,0,0,1,0,0,0,0,0,0,0,0,1,0,0,0,1,0,0,0,0,0,0,0,0,1,0,0,0,0,1,0,0,0
0,0,0,0,1,0,0,1,0,0,0,0,0,0,0,0,0,0,0,0,1,0,0,0,0,0,0,0,0,0,0,0,0,0,1,0,0,0
0,0,0,0,1,0,0,1,0,0,0,0,0,0,0,0,1,0,0,0,1,0,0,0,0,0,0,0,0,1,1,0,0,1,1,0,0,0
0,0,0,0,1,0,0,1,0,0,0,0,0,0,0,0,1,0,0,0,1,0,0,0,0,0,0,0,0,0,1,1,1,1,0,0,0,0
0,0,1,1,1,0,0,1,0,0,0,0,0,0,0,0,1,0,0,0,1,0,0,0,0,0,0,0,0,0,0,0,1,0,0,0,0,0
0,0,0,0,1,0,0,1,1,1,0,1,1,1,1,1,1,0,0,0,0,0,0,0,0,0,0,0,0,0,0,0,0,0,0,0,0,0
0,0,0,0,0,0,0,1,0,0,0,0,0,0,0,0,1,0,0,0,0,0,0,0,0,0,0,0,0,0,0,0,0,0,0,0,0,0
0,0,1,1,1,0,0,1,0,0,0,0,0,0,0,0,1,0,0,0,1,0,0,0,0,0,0,0,0,0,1,1,1,1,0,0,0,0
0,0,0,0,1,0,0,1,0,0,0,0,0,0,0,0,1,0,0,0,1,0,0,0,0,0,0,0,0,1,1,0,0,1,1,0,0,0
0,0,0,0,1,0,0,0,0,0,0,0,0,0,0,0,1,0,0,0,1,0,0,0,0,0,0,0,0,1,0,0,0,0,1,0,0,0
0,0,0,0,1,0,0,1,0,0,0,0,0,0,0,0,1,0,0,0,1,0,0,0,0,0,0,0,0,0,0,0,0,0,1,0,0,0
0,0,0,0,1,0,0,1,1,1,0,1,1,1,1,1,1,1,0,1,1,0,0,0,0,0,0,0,0,1,1,0,0,1,1,0,0,0
0,0,0,0,1,0,0,1,0,0,0,0,0,0,0,0,0,0,0,0,1,0,0,0,0,0,0,0,0,1,1,1,1,1,0,0,0,0
0,0,0,0,1,0,0,1,0,0,0,0,0,0,0,0,0,0,0,1,0,0,0,0,0,0,0,0,0,1,0,0,0,0,0,0,0,0
0,0,0,0,1,0,1,1,0,0,1,1,1,1,1,1,1,1,1,0,0,0,0,0,0,0,0,0,0,1,0,0,0,0,0,0,0,0
0,0,0,0,1,0,1,0,0,0,1,0,0,0,0,0,0,0,0,0,0,0,0,0,0,0,0,0,0,1,0,0,0,0,0,0,0,0
0,0,0,0,1,0,1,1,1,1,0,0,0,0,0,0,0,0,0,0,0,0,0,0,0,0,0,0,1,1,0,0,0,0,0,0,0,0
0,0,0,0,1,0,0,0,0,0,0,0,0,0,0,0,0,0,0,0,0,0,0,0,0,0,0,1,1,0,0,0,0,0,0,0,0,0
0,0,0,0,1,0,0,0,0,0,0,0,0,0,0,0,0,0,0,0,0,0,0,0,0,0,1,1,0,0,0,0,0,0,0,0,0,0
0,0,0,0,1,0,0,0,0,0,0,0,0,0,0,0,0,0,0,0,0,0,0,0,0,1,1,0,0,0,0,0,0,0,0,0,0,0
0,0,0,0,1,0,0,0,0,0,0,0,0,0,0,0,0,0,0,0,0,0,0,0,1,1,0,0,0,0,0,0,0,0,0,0,0,0
0,0,0,0,1,1,0,0,0,0,0,0,0,0,0,0,0,1,1,1,1,1,1,1,1,0,0,0,0,0,0,0,0,0,0,0,0,0
0,0,0,0,0,1,1,0,0,0,0,0,0,0,0,0,1,1,0,0,0,0,0,0,0,0,0,0,0,0,0,0,0,0,0,0,0,0
0,0,0,0,0,0,1,1,1,1,1,1,1,1,1,1,1,0,0,0,0,0,0,0,0,0,0,0,0,0,0,0,0,0,0,0,0,0
0,0,0,0,0,0,0,0,0,0,0,0,0,0,0,0,0,0,0,0,0,0,0,0,0,0,0,0,0,0,0,0,0,0,0,0,0,0