27,27,27,27,27,27,27,27,27,27,27,27,27,27,27,27,27,27,27,27,27,27,27,27,27,27,27,27,27,27,27,27,27,27,27,27,27,27
27,27,27,27,27,27,23,10,10,10,10,10,10,10,10,10,24,27,27,27,27,27,27,27,27,27,27,27,27,27,27,27,27,27,27,27,27,27
27,27,27,27,27,23,34,27,27,27,27,27,27,27,27,33,10,24,27,27,27,27,27,27,27,27,27,27,27,27,27,27,27,27,27,27,27,27
27,27,27,27,23,34,27,27,27,27,27,27,27,27,27,27,33,10,10,10,10,10,10,10,24,27,27,27,27,27,27,27,27,27,27,27,27,27
27,27,27,27,34,27,27,27,27,27,27,27,27,27,27,27,27,27,27,27,27,27,27,27,33,24,27,27,27,27,27,27,27,27,27,27,27,27
27,27,27,27,27,27,27,27,27,27,27,27,27,27,27,27,27,27,27,27,27,27,27,27,27,33,24,27,27,27,27,27,27,27,27,27,27,27
27,27,27,27,27,27,27,30,30,09,27,27,27,27,27,27,27,27,27,27,27,27,27,27,27,27,33,24,27,27,27,27,27,27,27,27,27,27
27,27,27,27,27,27,27,30,30,30,27,27,27,27,27,27,27,27,27,27,27,27,27,27,27,27,27,33,24,27,27,27,27,27,27,27,27,27
27,27,27,27,27,27,27,18,30,30,27,27,27,27,27,27,27,27,27,27,27,27,27,27,27,27,27,27,33,24,27,27,27,27,27,27,27,27
27,27,27,27,27,27,27,27,30,30,30,30,30,30,30,30,30,30,09,27,27,27,27,01,20,20,02,27,27,10,27,27,27,27,27,27,27,27
27,27,27,27,27,27,27,27,30,30,30,30,30,30,30,30,30,30,30,09,27,27,27,20,20,20,20,27,27,10,27,27,27,27,27,27,27,27
27,27,27,27,27,27,27,27,20,20,20,20,20,20,20,20,30,30,30,30,27,27,27,20,20,20,20,27,27,10,27,27,27,27,27,27,27,27
27,27,27,27,27,27,27,27,20,20,20,20,20,20,20,20,20,30,20,30,27,27,27,11,20,20,12,27,27,10,08,30,30,09,27,27,27,27
27,27,27,27,27,27,27,27,20,20,20,20,20,20,20,20,30,20,30,20,27,27,27,27,20,20,27,27,27,10,30,30,30,30,27,27,27,27
27,27,27,27,27,27,27,27,20,20,20,20,20,20,20,20,20,30,20,30,27,27,27,27,20,20,27,27,05,20,30,30,30,30,27,27,27,27
27,27,27,27,27,27,27,27,20,20,20,20,20,20,20,20,30,20,30,20,27,27,27,27,20,20,27,27,20,12,30,30,30,30,27,27,27,27
27,27,27,27,27,27,27,27,20,20,20,20,20,20,20,20,20,30,20,30,27,27,27,27,20,20,27,27,20,27,18,30,30,19,27,27,27,27
27,27,27,27,27,27,27,27,20,20,20,20,20,20,20,20,30,20,30,20,27,27,27,27,20,20,02,01,20,02,27,27,27,27,30,27,27,01
27,27,08,30,27,27,27,27,20,20,20,20,20,20,20,20,20,30,20,30,30,17,17,17,20,20,20,20,20,20,20,20,20,20,20,20,20,20
27,27,30,30,27,27,27,27,07,07,07,07,07,07,07,07,30,20,30,20,30,17,17,17,20,20,20,20,20,20,20,20,20,20,20,20,20,20
27,27,18,30,27,27,27,27,07,07,07,07,07,07,07,07,20,30,20,30,27,27,27,27,20,20,12,11,20,12,27,27,27,27,30,27,27,11
27,27,27,27,27,27,27,27,07,07,07,07,07,07,07,07,30,20,30,20,27,27,27,27,20,20,27,27,20,27,08,30,30,09,27,27,27,27
27,27,27,27,27,27,27,17,07,07,07,07,07,07,07,07,20,30,20,30,27,27,27,27,20,20,27,27,20,02,30,30,30,30,27,27,27,27
27,27,27,27,27,27,27,27,07,07,07,07,07,07,07,07,30,20,30,20,27,27,27,27,20,20,27,27,15,20,30,30,30,30,27,27,27,27
27,27,27,27,27,27,27,27,07,07,07,07,07,07,07,07,20,30,20,30,27,27,27,27,20,20,27,27,27,10,30,30,30,30,27,27,27,27
27,27,27,27,27,27,27,27,30,30,30,30,30,30,30,30,30,30,30,30,27,27,27,27,20,20,02,27,27,10,18,30,30,19,27,27,27,27
27,27,27,27,27,27,27,27,30,30,30,30,30,30,30,30,30,30,30,19,27,27,27,20,20,20,20,27,27,10,27,27,27,27,27,27,27,27
27,27,27,27,27,27,27,08,30,30,30,30,30,30,30,30,30,30,19,27,27,27,27,20,20,20,20,27,27,10,27,27,27,27,27,27,27,27
27,27,27,27,27,27,27,30,30,30,27,27,27,27,27,27,27,27,27,27,27,27,27,11,20,20,12,27,27,10,27,27,27,27,27,27,27,27
27,27,27,27,27,27,27,30,30,19,27,27,27,27,27,27,27,27,27,27,27,27,27,27,27,27,27,27,23,34,27,27,27,27,27,27,27,27
27,27,27,27,27,27,27,27,27,27,27,27,27,27,27,27,27,27,27,27,27,27,27,27,27,27,27,23,34,27,27,27,27,27,27,27,27,27
27,27,27,27,27,27,27,27,27,27,27,27,27,27,27,27,27,27,27,27,27,27,27,27,27,27,23,34,27,27,27,27,27,27,27,27,27,27
27,27,27,27,27,27,27,27,27,27,27,27,27,27,27,27,27,27,27,27,27,27,27,27,27,23,34,27,27,27,27,27,27,27,27,27,27,27
27,27,27,27,24,27,27,27,27,27,27,27,27,27,27,27,27,27,27,27,27,27,27,27,23,34,27,27,27,27,27,27,27,27,27,27,27,27
27,27,27,27,33,24,27,27,27,27,27,27,27,27,27,27,23,10,10,10,10,10,10,10,34,27,27,27,27,27,27,27,27,27,27,27,27,27
27,27,27,27,27,33,24,27,27,27,27,27,27,27,27,23,10,34,27,27,27,27,27,27,27,27,27,27,27,27,27,27,27,27,27,27,27,27
27,27,27,27,27,27,33,10,10,10,10,10,10,10,10,10,34,27,27,27,27,27,27,27,27,27,27,27,27,27,27,27,27,27,27,27,27,27
27,27,27,27,27,27,27,27,27,27,27,27,27,27,27,27,27,27,27,27,27,27,27,27,27,27,27,27,27,27,27,27,27,27,27,27,27,27